info {
bg:145;
}

tiles {
145,145,145,145,145,145,145,145,145,145,145,145,145,145,145,145,145,145,145,145,145,145,145,145,147,11,11,11,19,19,19,7,8,7,8,7,8,150,137,137,138,138,138,138,138,156,149,164,145,145
145,145,145,145,145,145,145,145,145,145,145,145,145,145,145,145,145,145,145,145,145,145,145,145,147,11,11,11,19,19,19,5,6,5,6,5,6,150,137,137,139,139,139,139,139,40,40,148,145,145
145,145,145,145,145,145,145,145,145,145,145,145,145,145,145,145,145,145,145,145,145,145,145,145,147,11,11,11,19,19,19,7,8,7,8,41,42,150,137,137,137,137,137,137,137,167,40,148,145,145
145,145,145,145,145,145,145,145,145,145,145,145,145,145,145,145,145,145,145,145,145,145,145,145,147,9,9,9,131,133,132,5,6,5,6,43,44,150,137,137,137,137,39,137,137,150,40,148,145,145
145,145,145,145,145,145,145,145,145,165,149,149,149,149,149,149,149,149,149,149,149,149,149,149,172,9,9,9,130,7,8,7,8,7,8,45,46,150,137,137,137,173,151,151,151,157,40,148,145,145
145,145,145,145,145,145,145,145,145,147,27,27,27,27,27,27,27,27,27,27,39,27,27,27,150,9,9,9,129,5,6,5,6,5,6,5,6,150,137,137,137,137,137,137,137,150,40,148,145,145
145,145,145,145,145,165,149,149,149,155,27,27,27,27,27,39,27,27,27,27,27,27,27,27,150,9,9,9,130,7,8,7,8,7,8,7,8,175,151,151,151,151,174,137,173,192,40,148,145,145
145,145,145,145,145,147,27,27,27,27,27,27,171,151,151,151,151,151,151,151,151,174,27,27,168,9,9,9,129,5,6,5,6,5,6,5,6,5,6,5,6,5,6,5,134,11,40,148,145,145
145,145,145,145,145,147,27,27,27,27,27,27,150,5,6,5,6,5,6,5,6,5,6,5,6,65,20,56,130,7,8,7,8,7,8,7,8,7,8,7,8,7,8,7,134,11,40,148,145,145
145,145,145,145,145,147,27,39,39,27,27,27,150,7,8,7,8,7,8,7,8,7,8,7,8,20,20,56,129,5,6,5,6,5,6,5,6,5,6,5,6,5,6,5,134,11,154,152,145,145
145,145,145,145,145,147,27,27,27,27,27,27,150,5,6,5,6,5,6,5,6,5,6,5,6,63,20,56,154,146,146,146,146,146,146,146,177,178,11,11,11,184,146,146,146,146,152,145,145,145
145,145,145,145,145,147,27,27,27,27,27,27,150,7,8,7,173,193,146,146,146,146,146,146,153,57,20,56,148,145,145,145,145,145,145,145,179,180,11,11,11,185,145,145,145,145,145,145,145,145
145,145,145,145,145,147,27,27,27,171,151,151,157,5,6,5,40,148,145,145,145,145,145,145,147,57,64,66,148,145,145,145,145,145,145,145,145,181,11,11,11,186,187,145,145,145,145,145,145,145
145,145,145,145,145,147,27,27,27,168,40,40,150,7,8,7,40,148,145,145,145,145,145,145,147,57,56,39,148,145,145,145,145,145,145,145,145,182,11,11,11,188,189,145,145,145,145,145,145,145
145,145,145,145,145,147,39,27,1,1,40,40,150,5,6,5,154,152,145,145,145,145,145,145,147,57,56,39,148,145,145,145,145,145,145,145,145,183,178,11,11,11,190,145,145,145,145,145,145,145
145,145,165,149,149,161,151,151,151,170,40,40,150,7,8,7,148,145,145,145,145,145,145,145,147,57,62,67,148,145,145,145,145,145,145,145,145,179,180,11,11,11,185,145,145,145,145,145,145,145
145,145,147,37,36,36,36,36,36,168,40,40,150,5,6,5,148,145,145,145,145,145,145,145,147,60,63,56,148,145,145,145,145,145,145,145,145,145,181,11,11,11,186,187,145,145,145,145,145,145
145,145,147,33,11,11,11,11,11,40,40,40,150,7,8,7,148,145,145,145,145,145,145,145,147,39,57,56,148,145,145,145,145,145,145,145,145,145,182,11,11,11,188,189,145,145,145,145,145,145
145,145,147,33,11,55,35,35,35,167,40,40,150,5,6,5,148,145,145,145,145,145,145,145,147,135,65,56,148,145,145,145,145,145,145,145,145,145,147,11,11,11,11,148,145,145,145,145,145,145
145,145,147,33,11,34,20,21,20,175,151,151,176,7,8,7,156,149,149,149,149,149,149,149,155,57,20,56,148,145,145,145,145,145,145,145,145,145,147,11,11,11,11,148,145,145,145,145,145,145
145,145,147,33,11,39,22,23,20,58,58,58,58,65,20,62,58,58,58,58,58,58,58,58,58,65,20,56,148,145,145,145,145,145,145,145,145,145,147,11,11,11,11,148,145,145,145,145,145,145
145,145,147,33,11,12,24,25,20,20,20,20,20,20,20,64,59,59,63,20,20,20,20,20,20,20,20,56,148,145,145,145,145,145,145,145,145,145,147,11,11,11,11,148,145,145,145,145,145,145
145,145,147,32,9,10,26,20,20,59,59,59,59,63,20,56,39,39,60,59,59,59,59,59,59,59,63,56,148,145,145,145,145,145,145,145,145,145,147,11,11,140,141,148,145,145,145,145,145,145
145,145,147,32,9,10,20,20,56,154,146,146,153,5,6,5,154,146,146,146,146,146,146,146,146,153,57,56,148,145,145,145,145,145,145,145,145,145,147,11,11,142,143,148,145,145,145,145,145,145
145,145,147,32,9,10,20,20,56,148,145,145,147,7,8,7,148,145,145,145,165,149,149,149,149,172,57,56,148,145,145,145,145,145,145,145,145,145,147,11,11,11,11,148,145,145,145,145,145,145
145,145,147,32,9,10,20,20,56,148,145,145,160,153,137,171,191,149,149,149,155,137,137,137,137,150,57,56,156,149,149,149,149,149,164,145,145,145,147,11,11,11,11,148,145,145,145,145,145,145
145,145,147,32,9,10,20,20,56,148,145,145,145,147,137,150,137,137,137,137,137,137,137,137,137,150,57,62,58,58,58,58,58,67,148,145,145,145,147,11,11,154,146,152,145,145,145,145,145,145
145,145,147,32,9,10,20,20,56,148,145,145,145,147,137,168,137,137,137,137,167,137,137,137,137,150,57,20,64,59,59,59,63,56,148,145,145,145,147,11,11,156,149,164,145,145,145,145,145,145
145,145,147,32,9,10,20,20,56,148,145,145,145,147,137,137,137,137,137,137,150,39,137,137,137,150,60,59,66,154,146,153,57,56,148,145,145,145,147,11,11,1,27,148,145,145,145,145,145,145
145,145,147,32,9,10,20,20,56,148,145,145,145,160,146,153,137,137,137,39,150,39,39,137,137,163,146,146,146,152,145,147,57,56,148,145,145,145,147,57,56,154,146,152,145,145,145,145,145,145
145,145,147,57,20,20,20,20,56,148,145,145,145,145,145,160,169,151,151,151,158,151,170,137,154,152,145,145,165,149,149,155,57,56,156,149,149,149,155,57,56,156,149,164,145,145,145,145,145,145
145,165,155,60,59,63,20,20,56,148,145,145,145,145,145,145,147,137,39,39,137,137,168,137,148,145,145,145,147,56,39,135,65,62,58,58,58,58,58,65,56,20,20,148,145,145,145,145,145,145
145,147,39,39,39,57,20,20,56,156,149,149,164,145,145,145,147,137,137,137,137,137,137,137,148,145,145,145,147,62,135,136,59,59,59,59,59,59,59,59,66,20,20,148,145,145,145,145,145,145
145,147,39,39,39,57,20,20,62,58,58,67,148,145,145,145,147,137,137,137,137,137,154,146,152,145,145,145,160,153,57,56,154,146,146,146,146,146,146,146,153,20,20,148,145,145,145,145,145,145
145,147,39,39,39,57,20,20,20,20,20,56,148,145,145,145,147,137,137,137,137,39,148,145,145,145,145,145,145,147,57,56,148,145,145,145,145,145,145,145,147,20,20,148,145,145,145,145,145,145
145,147,39,39,39,60,59,59,59,63,20,56,148,145,145,145,147,137,137,144,39,39,148,145,145,145,145,145,145,147,57,56,148,145,145,145,145,145,145,145,147,20,20,156,164,145,145,145,145,145
145,160,146,146,146,169,151,151,170,57,20,56,148,145,145,145,160,146,153,144,154,146,152,145,145,145,145,145,165,155,57,56,156,149,149,149,149,149,149,149,155,20,20,20,148,145,145,145,145,145
145,145,145,145,145,147,20,20,168,57,20,56,148,145,145,145,165,149,155,137,156,149,149,149,164,145,145,145,147,56,65,62,60,59,59,59,59,59,59,59,63,20,20,20,148,145,145,145,145,145
145,145,145,145,145,147,20,20,20,57,20,56,148,145,145,145,147,137,137,137,137,137,137,137,148,145,145,145,147,56,28,29,28,29,28,29,28,29,103,29,57,105,20,20,148,145,145,145,145,145
145,145,145,145,145,147,20,20,167,57,20,56,148,145,145,145,147,137,137,137,137,39,137,137,148,145,145,145,147,56,30,31,30,31,30,31,30,31,30,31,57,154,146,146,152,145,145,145,145,145
145,145,145,145,145,160,146,146,166,57,20,56,148,145,145,145,160,146,146,146,153,57,20,56,148,145,145,145,147,126,28,29,28,68,69,70,71,29,28,29,57,148,145,145,145,145,145,145,145,145
145,145,145,145,145,145,145,145,147,57,20,56,156,149,149,149,149,149,149,149,155,57,20,56,156,149,149,149,155,56,30,31,72,73,74,75,76,77,30,31,57,148,145,145,145,145,145,145,145,145
145,145,145,145,145,145,145,145,147,57,20,56,2,2,2,2,2,3,3,3,3,57,20,56,20,20,20,20,20,56,28,29,78,79,28,29,80,81,28,29,57,148,145,145,145,145,145,145,145,145
145,145,145,145,145,145,165,149,155,57,20,56,2,2,2,2,2,3,3,3,3,57,20,56,20,20,20,20,20,56,30,31,82,83,30,31,84,85,30,31,57,148,145,145,145,145,145,145,145,145
145,145,145,145,145,145,147,20,20,57,20,56,2,2,2,2,2,3,3,3,3,57,20,56,154,146,146,146,153,56,28,29,86,87,28,29,88,89,28,29,57,148,145,145,145,145,145,145,145,145
145,145,145,145,145,145,160,146,153,57,20,56,2,2,2,2,2,3,3,3,3,57,20,56,148,145,145,145,147,98,99,31,90,91,30,31,92,93,30,31,57,148,145,145,145,145,145,145,145,145
145,145,145,145,145,145,145,145,147,57,20,56,2,2,2,2,2,3,3,3,3,57,20,56,148,145,145,145,147,100,101,29,28,29,28,29,28,29,28,29,57,156,149,149,149,164,145,145,145,145
145,145,145,145,145,145,145,145,147,115,20,109,107,2,2,2,2,3,3,3,194,106,20,112,148,145,145,145,147,102,30,31,30,31,30,31,30,31,30,31,57,20,20,20,104,148,145,145,145,145
145,145,145,145,145,145,145,145,147,116,114,20,108,2,2,2,2,3,3,3,195,20,111,113,148,145,145,145,147,62,58,58,58,58,58,58,58,58,58,58,65,105,20,20,104,148,145,145,145,145
145,145,145,145,145,145,145,145,147,110,115,20,109,107,2,2,2,3,3,194,106,20,112,110,148,145,145,145,147,105,20,94,95,104,20,154,146,146,146,146,146,153,20,39,39,148,145,145,145,145
145,145,145,145,145,145,145,145,147,110,116,114,20,108,2,2,4,3,3,195,20,111,113,110,148,145,145,145,160,146,146,146,146,146,146,152,145,145,145,145,145,147,20,39,39,148,145,145,145,145
145,145,145,145,145,145,145,145,147,110,110,115,20,109,107,2,4,3,194,106,20,112,110,110,148,145,145,145,145,145,145,145,145,145,145,145,145,145,145,145,145,160,146,146,146,152,145,145,145,145
145,145,145,145,145,145,145,145,147,110,110,116,114,20,108,2,4,3,195,20,111,113,110,39,148,145,145,145,145,145,145,145,145,145,145,145,145,145,145,145,145,145,145,145,145,145,145,145,145,145
145,145,145,145,145,145,145,145,147,39,39,110,115,20,109,107,4,194,106,20,112,110,39,39,148,145,145,145,145,145,145,145,145,145,145,145,145,145,145,145,145,145,145,145,145,145,145,145,145,145
145,145,145,145,145,145,145,145,147,39,39,110,116,114,20,108,4,195,20,111,113,39,39,39,148,145,145,145,145,145,145,145,145,145,145,145,145,145,145,145,145,145,145,145,145,145,145,145,145,145
145,145,145,145,145,145,145,145,160,146,146,146,153,57,20,62,125,65,20,56,154,146,146,146,152,145,145,145,145,145,145,145,145,145,145,145,145,145,145,145,145,145,145,145,145,145,145,145,145,145
145,145,145,145,145,145,145,145,145,16,17,18,147,57,20,20,20,20,20,56,148,145,145,145,145,145,145,145,145,145,145,145,145,145,145,145,145,145,145,145,145,145,145,145,145,145,145,145,145,145
145,145,145,145,145,145,145,145,145,13,14,15,147,57,20,20,20,20,20,56,148,145,145,145,145,145,145,145,145,145,145,145,145,145,145,145,145,145,145,145,145,145,145,145,145,145,145,145,145,145
145,145,145,145,145,145,145,145,165,149,149,149,155,57,20,20,20,20,20,56,148,145,145,145,145,145,145,145,145,145,145,145,145,154,146,146,146,146,146,146,146,146,146,146,146,153,145,145,145,145
145,145,145,145,145,145,145,145,147,39,39,110,128,57,20,47,48,49,20,56,148,145,145,145,145,145,145,145,145,145,145,145,145,148,145,145,0,145,145,145,145,145,0,145,145,147,145,145,145,145
145,145,145,145,145,145,145,145,147,39,39,110,128,57,20,50,20,51,20,56,148,145,145,145,145,145,145,145,145,145,145,145,145,148,145,145,145,0,145,145,145,0,145,145,145,147,145,145,145,145
145,145,145,145,145,145,145,145,147,110,110,110,128,57,20,52,53,54,20,56,148,145,145,145,145,145,145,145,145,145,145,145,145,148,145,145,0,0,0,0,0,0,0,145,145,147,145,145,145,145
145,145,145,145,145,145,145,145,147,110,128,9,10,57,20,20,20,20,20,56,148,145,145,145,145,145,145,145,145,145,145,145,145,148,145,0,0,145,0,0,0,145,0,0,145,147,145,145,145,145
145,145,145,145,145,145,145,145,147,110,128,9,10,57,20,20,20,20,20,56,148,145,145,145,145,145,145,145,145,145,145,145,145,148,0,0,0,0,0,0,0,0,0,0,0,147,145,145,145,145
145,145,145,145,145,145,145,145,147,110,128,9,10,60,59,63,20,64,59,66,148,145,145,145,145,145,145,145,145,145,145,145,145,148,0,145,0,0,0,0,0,0,0,145,0,147,145,145,145,145
145,145,145,145,145,145,145,145,147,110,128,110,110,110,127,57,20,56,127,110,148,145,145,145,145,145,145,145,145,145,145,145,145,148,0,145,0,145,145,145,145,145,0,145,0,147,145,145,145,145
145,145,145,145,145,145,145,145,160,146,146,146,146,146,153,60,59,66,154,146,152,145,145,145,145,145,145,145,145,145,145,145,145,148,145,145,145,0,0,145,0,0,145,145,145,147,145,145,145,145
145,145,145,145,145,145,145,145,145,145,145,145,145,145,160,146,146,146,152,145,145,145,145,145,145,145,145,145,145,145,145,145,145,156,149,149,149,149,149,149,149,149,149,149,149,155,145,145,145,145
}

collision {
(1120,128),(1128,136),(1128,160),(1152,152),(1152,160),(1184,160),(1184,64),(1120,64),(1120,128)
(672,160),(672,192),(640,192),(640,160),(672,160)
(512,192),(512,224),(480,224),(480,192),(512,192)
(288,288),(288,320),(224,320),(224,288),(288,288)
(224,448),(224,480),(192,480),(192,448),(224,448)
(320,160),(768,160),(320,160)
(320,224),(320,160),(320,224)
(192,224),(320,224),(192,224)
(192,480),(192,224),(192,480)
(320,480),(192,480),(320,480)
(288,448),(288,384),(288,448)
(320,448),(288,448),(320,448)
(384,384),(288,384),(384,384)
(384,224),(384,384),(384,224)
(704,224),(384,224),(704,224)
(704,256),(704,224),(704,256)
(416,256),(704,256),(416,256)
(416,640),(416,256),(416,640)
(288,640),(416,640),(288,640)
(288,608),(288,640),(288,608)
(192,608),(288,608),(192,608)
(192,960),(192,608),(192,960)
(192,672),(160,672),(160,640),(192,640),(192,672)
(320,416),(320,416),(320,448),(320,416)
(384,416),(320,416),(384,416)
(384,608),(384,416),(384,608)
(320,608),(384,608),(320,608)
(320,576),(320,608),(320,576)
(288,576),(320,576),(288,576)
(288,592),(288,576),(288,592)
(176,592),(288,592),(176,592)
(176,640),(176,592),(176,640)
(320,544),(320,480),(320,544)
(288,544),(320,544),(288,544)
(288,528),(288,544),(288,528)
(112,528),(288,528),(112,528)
(512,352),(800,352),(512,352)
(512,384),(512,352),(512,384)
(544,384),(512,384),(544,384)
(544,448),(544,384),(544,448)
(512,448),(544,448),(512,448)
(512,640),(512,448),(512,640)
(800,640),(512,640),(800,640)
(800,576),(800,640),(800,576)
(832,544),(832,576),(800,576),(800,544),(832,544)
(800,544),(800,352),(800,544)
(896,832),(896,320),(896,832)
(896,480),(864,480),(864,416),(896,416),(896,480)
(768,256),(768,160),(768,256)
(800,256),(768,256),(800,256)
(800,0),(800,256),(800,0)
(1440,0),(800,0),(1440,0)
(1184,224),(1184,0),(1184,224)
(1376,224),(1184,224),(1376,224)
(1376,192),(1376,224),(1376,192)
(1216,192),(1376,192),(1216,192)
(1216,0),(1216,192),(1216,0)
(1184,320),(896,320),(1184,320)
(1472,320),(1312,320),(1472,320)
(1472,288),(1472,320),(1472,288)
(1504,288),(1472,288),(1504,288)
(1504,32),(1504,288),(1504,32)
(1440,32),(1504,32),(1440,32)
(1440,0),(1440,32),(1440,0)
(1312,64),(1472,64),(1312,64)
(1376,128),(1344,128),(1344,96),(1376,96),(1376,128)
(1472,224),(1472,64),(1472,224)
(1408,224),(1472,224),(1408,224)
(1408,192),(1408,224),(1408,192)
(1440,192),(1408,192),(1440,192)
(1440,160),(1440,192),(1440,160)
(1312,160),(1440,160),(1312,160)
(1312,128),(1312,160),(1312,128)
(1344,128),(1312,128),(1344,128)
(1440,128),(1376,128),(1440,128)
(1440,64),(1440,128),(1440,64)
(896,96),(896,320),(896,96)
(992,96),(896,96),(992,96)
(1248,576),(1184,320),(1248,576)
(1376,576),(1312,320),(1376,576)
(1248,992),(1248,576),(1248,992)
(1376,832),(1376,576),(1376,832)
(1312,832),(1376,832),(1312,832)
(1312,896),(1312,832),(1312,896)
(1376,896),(1312,896),(1376,896)
(1376,928),(1376,896),(1376,928)
(1312,928),(1376,928),(1312,928)
(1312,992),(1312,928),(1312,992)
(1376,992),(1312,992),(1376,992)
(1088,992),(1248,992),(1088,992)
(1088,832),(1088,992),(1088,832)
(896,832),(1088,832),(896,832)
(576,704),(576,736),(512,736),(512,704),(576,704)
(416,736),(288,736),(416,736)
(416,800),(416,736),(416,800)
(448,800),(416,800),(448,800)
(480,800),(512,800),(480,800)
(512,736),(512,800),(512,736)
(832,736),(512,736),(832,736)
(832,928),(832,736),(832,928)
(928,928),(832,928),(928,928)
(928,896),(928,928),(928,896)
(1024,896),(928,896),(1024,896)
(1024,992),(1024,896),(1024,992)
(992,992),(1024,992),(992,992)
(960,992),(960,1024),(992,1024),(992,992),(960,992)
(928,992),(960,992),(928,992)
(928,1056),(928,992),(928,1056)
(960,1056),(928,1056),(960,1056)
(1312,1056),(1312,1184),(1024,1184),(1024,1056),(1312,1056)
(1376,1152),(1376,992),(1376,1152)
(1408,1152),(1376,1152),(1408,1152)
(1408,1248),(1408,1152),(1408,1248)
(1312,1248),(1408,1248),(1312,1248)
(960,1184),(960,1056),(960,1184)
(928,1184),(960,1184),(928,1184)
(928,1344),(928,1184),(928,1344)
(768,1344),(928,1344),(768,1344)
(768,1216),(768,1344),(768,1216)
(704,1248),(704,1280),(672,1280),(672,1248),(704,1248)
(640,1216),(768,1216),(640,1216)
(640,1152),(640,1216),(640,1152)
(704,1152),(672,1152),(672,1088),(704,1088),(704,1152)
(672,1120),(672,1152),(640,1152),(640,1120),(672,1120)
(704,1056),(704,1088),(704,1056)
(768,1056),(704,1056),(768,1056)
(768,960),(768,1056),(768,960)
(800,960),(768,960),(800,960)
(800,800),(800,960),(800,800)
(672,800),(800,800),(672,800)
(672,832),(672,800),(672,832)
(512,832),(672,832),(512,832)
(512,896),(512,832),(512,896)
(480,896),(512,896),(480,896)
(480,800),(480,896),(480,800)
(448,928),(448,800),(448,928)
(512,928),(448,928),(512,928)
(512,960),(512,928),(512,960)
(608,960),(512,960),(608,960)
(640,960),(640,928),(608,928),(608,960),(640,960)
(640,864),(640,928),(640,864)
(672,864),(640,864),(672,864)
(672,896),(672,864),(672,896)
(672,896),(672,960),(704,960),(704,896),(672,896)
(704,960),(736,960),(736,928),(704,928),(704,960)
(736,1024),(736,960),(736,1024)
(704,1024),(736,1024),(704,1024)
(704,992),(704,1024),(704,992)
(640,992),(704,992),(640,992)
(576,992),(576,1024),(640,1024),(640,992),(576,992)
(544,992),(576,992),(544,992)
(544,1152),(544,992),(544,1152)
(608,1152),(544,1152),(608,1152)
(608,1216),(608,1152),(608,1216)
(544,1216),(608,1216),(544,1216)
(544,1280),(544,1216),(544,1280)
(672,1280),(544,1280),(672,1280)
(672,1504),(672,1280),(672,1504)
(544,1760),(672,1504),(544,1760)
(512,1760),(544,1760),(512,1760)
(384,1504),(512,1760),(384,1504)
(384,1056),(384,1504),(384,1056)
(288,1056),(384,1056),(288,1056)
(288,736),(288,1056),(288,736)
(176,960),(192,960),(176,960)
(176,672),(176,960),(176,672)
(112,960),(96,960),(112,960)
(112,528),(112,960),(112,528)
(112,528),(112,528)
(96,1024),(96,960),(96,1024)
(160,1024),(96,1024),(160,1024)
(160,1152),(160,1024),(160,1152)
(288,1152),(160,1152),(288,1152)
(288,1216),(288,1152),(288,1216)
(256,1216),(288,1216),(256,1216)
(256,1184),(256,1216),(256,1184)
(192,1184),(256,1184),(192,1184)
(192,1280),(192,1184),(192,1280)
(256,1280),(192,1280),(256,1280)
(256,1248),(256,1280),(256,1248)
(288,1248),(256,1248),(288,1248)
(288,1408),(288,1248),(288,1408)
(224,1408),(288,1408),(224,1408)
(224,1440),(224,1408),(224,1440)
(288,1440),(224,1440),(288,1440)
(288,1504),(288,1440),(288,1504)
(416,1760),(288,1504),(416,1760)
(416,1980),(416,1760),(416,1980)
(352,2112),(352,1984),(352,2112)
(352,1888),(352,1952),(288,1952),(288,1888),(352,1888)
(288,2112),(352,2112),(288,2112)
(288,1952),(288,2112),(288,1952)
(416,1888),(352,1888),(416,1888)
(480,2112),(352,2112),(480,2112)
(480,2144),(480,2112),(480,2144)
(576,2144),(480,2144),(576,2144)
(576,2112),(576,2144),(576,2112)
(640,2112),(576,2112),(640,2112)
(640,1760),(640,2096),(640,1760)
(768,1504),(640,1760),(768,1504)
(768,1408),(768,1504),(768,1408)
(928,1408),(768,1408),(928,1408)
(928,1600),(928,1408),(928,1600)
(1120,1600),(928,1600),(1120,1600)
(1120,1568),(1120,1600),(1120,1568)
(1344,1568),(1120,1568),(1344,1568)
(1344,1632),(1344,1568),(1344,1632)
(1376,1632),(1344,1632),(1376,1632)
(1440,1568),(1440,1632),(1376,1632),(1376,1568),(1440,1568)
(1088,1584),(1072,1600),(1056,1584),(1072,1568),(1088,1584)
(1440,1520),(1424,1536),(1408,1520),(1424,1504),(1440,1520)
(1440,1552),(1424,1568),(1408,1552),(1424,1536),(1440,1552)
(992,1600),(992,1584),(992,1600)
(1056,1600),(1056,1584),(1056,1600)
(1056,1584),(1048,1576),(1000,1576),(992,1584),(1056,1584)
(959,1516),(932,1506),(959,1516)
(982,1492),(989,1464),(982,1492)
(1440,1504),(1440,1568),(1440,1504)
(1312,1504),(1440,1504),(1312,1504)
(1312,1248),(1312,1504),(1312,1248)
(952,1296),(943,1301),(936,1296),(944,1288),(952,1296)
(536,1776),(528,1784),(520,1776),(528,1768),(536,1776)
(472,2096),(464,2104),(456,2096),(464,2088),(472,2096)
(600,2096),(592,2104),(584,2096),(592,2088),(600,2096)
(1360,720),(1376,736),(1360,752),(1344,768),(1328,768),(1312,736),(1312,720),(1344,704),(1360,720)
(1189,1366),(1182,1372),(1176,1364),(1182,1358),(1189,1366)
(1209,1372),(1203,1375),(1197,1369),(1204,1363),(1209,1372)
(1198,1458),(1204,1453),(1202,1389),(1198,1458)
(1072,1430),(1070,1440),(1044,1432),(1046,1422),(1072,1430)
(1055,1415),(1051,1414),(1055,1409),(1055,1415)
(1174,1322),(1169,1320),(1174,1316),(1174,1322)
(1135,1332),(1128,1332),(1130,1307),(1134,1307),(1135,1332)
(1058,1316),(1070,1331),(1059,1336),(1050,1320),(1058,1316)
}

collisionPeople {
(1408,320),(1408,224),(1408,320)
(968,1448),(976,1464),(968,1480),(952,1488),(936,1480),(928,1464),(936,1448),(952,1440),(968,1448)
(1335,1223),(1325,1232),(1319,1228),(1326,1219),(1335,1223)
(1335,1543),(1327,1549),(1319,1546),(1325,1538),(1335,1543)
(951,1575),(943,1583),(935,1579),(941,1573),(951,1575)
(608,1120),(608,1152),(608,1120)
(1033,1329),(1047,1352),(1083,1329),(1071,1307),(1033,1329)
(1182,1439),(1197,1439),(1198,1401),(1182,1401),(1182,1439)
(1072,1390),(1043,1391),(1044,1459),(1073,1458),(1072,1390)
(1092,1333),(1151,1335),(1151,1306),(1092,1308),(1092,1333)
(1212,1320),(1207,1347),(1158,1337),(1165,1310),(1212,1320)
(1248,1232),(1232,1248),(1216,1232),(1232,1216),(1248,1232)
(416,1984),(416,2072),(416,1984)
(252,652),(224,632),(192,696),(216,712),(252,652)
}

spawns {
(1,1056,64);(0,608,1824);(0,448,1824);(0,576,1888);(0,512,1824);(0,576,1984);(0,480,1888);(0,448,1984);(0,608,1920);(0,448,1920);(0,544,2080);(0,480,2016);(0,544,1920);(0,544,2016);(0,512,1984);(0,608,2016);(0,512,2112);(1,1376,256);(1,1312,256);(1,1248,256);(1,928,128);(1,992,128);(1,1064,128);(1,928,192);(1,1008,192);(1,1056,192);(1,1120,192);(1,928,256);(1,992,256);(1,1056,256);(1,1120,256);(1,1184,256);(2,1344,664);(2,464,752);(2,880,880);(2,1272,1528);(2,200,1112);(2,528,2048);(2,1032,184)
}

waypoints {
(1280,384);(448,1744);(608,1744);(656,1632);(392,1624);(720,1496);(344,1512);(1000,1200);(736,1384);(864,1376);(984,1336);(1008,1264);(1056,1024);(1160,1024);(1272,1016);(1280,896);(1280,800);(1280,544);(1248,288);(328,1376);(328,1256);(328,1128);(224,960);(224,856);(232,768);(256,696);(416,688);(464,616);(504,680);(464,480);(464,408);(464,344);(616,296);(696,296);(832,296);(824,408);(864,584);(872,736);(704,672);(872,856);(1024,856);(1056,952);(960,32);(840,56);(824,176);(1104,240);(1072,136);(944,144);(952,192);(1040,248);(1064,80);(1080,192);(1168,264);(888,32);(824,112);(824,232);(768,304);(832,352);(520,296);(824,456);(864,544);(848,672);(768,672);(872,792);(944,856);(1056,888);(1280,672);(944,1368);(992,1048);(352,688);(464,552);(632,672);(264,1096);(232,1032);(976,240);(1032,32);(1072,1256);(1144,1264);(1216,1288);(1280,1280);(1296,1208);(1344,1192);(1344,1128);(1352,1072);(1328,1024);(840,504);(856,624);(992,1120);(576,672)
}

guns {
}
